border_size=1
usage=map

Xu, Xu, Xu, Xu, Xu, Xu, Xu, Xu, Xu, Xu, Xu, Xu, Xu, Xu, Ss, Ss, Wog, Wog, Xu, Xu, Xu, Xu, Xu, Xu, Xu, Qxu, Uu^Vu, Qxu^Bs/, Qxu, Qxu, Qxu, Qxu, Xu, Xu, Xu, Xu, Qxu, Qxu, Qxu, Qxu, Qxu, Qxu, Qxu, Xu, Xu, Xu
Xu, Xu, Xu, Xu, Xu, Xu, Xu, Xu, Uu^Uf, Xu, Xu, Xu, Xu, Xu, Xu, Ss^Emf, Xu, Wog, Wog, Chs, Xu, Xu, Xu, Xu, Qxu, Qxu, Uu^Uf, Uu, 4 Kud, Uu^Uf, Uu, Qxu, Xu, Xu, Xu, Xu, Ur, Qxu, Qxu, Ur^Es, Ur, Qxu, Uu^Vu, Xu, Xu, Xu
Xu, Xu, Xu, Xu, Xu, Uu^Uf, Uh, Xue, Uue, Xue, Xol, Xu, Xu, Xu, Xu, Xu, Xu, Ss^Vhs, Wog, Chw^Ii, Xu, Xu, Xu, Xu, Xu, Qxu, Xu, Uu, Cud, Uu, Qxu, Uu^Vu, Uu^Uf, Xu, Qxu, Xu, Ur, Qxu, Uu^Vu, Ur, Ur, Ur^Es, Uu, Xu, Xu, Xu
Xu, Xu, Xu, Xu, Xol, Xue, Co^Ii, Uue, Uu^Vud, Qxe, Uue, Uu^Uf, Xu, Qxu, Qxu, Qxu, Uu, Ur^Es, Wog, Ss^Emf, Xu, Xu, Uu^Uf, Xu, Xu, Xu, Qxu, Uu, Uu, Uu^Vu, Qxu, Qxu, Uu, Xu, Ur, Ur, Ur, Qxu^Bs/, Qxu, Uu, Cud, 3 Kud, Uu, Uu^Vu, Xu, Xu
Xu, Xu, Uu^Uf, Xue, Uue, Xue, Co, Co, Rb, Rb, Rb, Qxe, Qxu, Ur^Es, Uu, Uu, Qxu, Wwf, Wwf, Wog, Uu^Vu, Qxu, Ur^Es, Ur, Ur, Uu^Uf, Ur^Es, Uu, Qxu, Uu^Uf, Xu, Xu, Uu^Uf, Ur, Qxu, Qxu, Qxu^Bs|, Qxu, Qxu, Uu^Es, Ur, Cud, Uu, Uu, Xu, Xu
Xu, Xu, Uu^Uf, Uue, Uue, Co^Ii, Uu^Vud, 1 Koa^Ii, Co, Co^Ii, Rb, Uh, Qxu^Bs/, Rb, Rb, Ur, Qxu^Bw\r, Qxu, Wwf, Wwf, Wwf, Ur, Urb, Xol, Urb, Ur, Ur, Ur, Qxu, Qxu, Qxu, Xu, Ur, Ur, Uu, Qxu, Uu^Es, Qxu, Ur^Es, Ur, Cud, Ur, Cud, Uu^Es, Gll^Ii, Gll^Fdf
Xu, Xu, Xue, Xol, Qxe, Uue, Uue, Co, Co^Ii, Uu^Vud, Uue, Rb, Qxe, Ur, Rb, Ur, Ur, Uu^Vu, Wwg, Wog, Wwg, Ur^Es, Qxua, Urb, Qxua, Urb^Es, Urb, Ur, Ur^Es, Ur, Qxu^Bw/r, Qxu^Bw/r, Qxu, Uu, Uu, Uu, Ur, Ur, Ur, Ur, Uu, 2 Kud, Uu, Uu, Gll^Es, Gll^Fdw
Xu, Xu, Xue, Qxe, Uu^Uf, Qxe, Uue, Uue, Uue, Uue, Uh, Uue, Xu, Uu^Vu, Ur^Es, Rb, Wwg, Wwg, Wog, Wog, Ur^Es, Ur, Urb, Qxua, Urb^Es, Urb, Ur, Ur, Ur, Ur, Xu, Qxu, Xu, Xu, Uu, Qxu, Qxu^Bs|, Ur^Es, Qxu, Ur, Ur, Cud, Uu, Uu, Gll^Fdw, Gll^Ii
Xu, Xu, Xu, Uu^Uf, Uu^Uf, Uue, Xol, Uu^Uf, Xue, Uu^Uf, Xue, Xol, Xu, Xu, Uu, Rb, Ur^Es, Wwg, Wog, Xu, Ur, Xol, Ur, Qxua, Urb, Xol, Ur, Ur^Es, Uu^Vu, Xu, Xu, Qxu, Qxu, Xu, Uu, Ur, Ur, Qxu, Qxu^Bs/, Uu^Vu, Uu, Ur, Uu, Gll^Ii, Gll^Fdw, Gll^Fdw
Xu, Xu, Xu, Xu, Xu, Xu, Xu, Xu, Xu, Xu, Xu, Xu, Xu, Qxu, Rb, Rb, Uu^Emf, Xu, Xu, Wog, Wwg, Ur, Ur, Urb, Ur, Ur, Qxu, Ur, Uu, Uu, Uu, Qxu, Uu^Vu, Uu, Xu, Ur, Qxu, Ur, Qxu, Qxu, Uu^Vu, Ur, Ur^Es, Uu^Vu, Xu, Xu
Xu, Xu, Xu, Xu, Xu, Xu, Xu, Xu, Xu, Xu, Xu, Xu, Uu^Vud, Rb, Uu^Es, Uu^Vud, Xu, Xu, Xu, Wog, Xu, Qxu, Xu, Ur^Es, Qxu, Qxu, Xu, Qxu, Uu, Cud, Uu^Uf, Uu, Qxu, Qxu, Xu, Qxu, Xu, Qxu, Xu, Qxu, Qxu, Qxu, Qxu, Qxu, Xu, Xu
Xu, Xu, Xu, Xu, Xu, Xu, Xu, Xu, Xu, Xu, Xu, Xu, Uu^Emf, Rb, Qxu, Xu, Xu, Xu, Wog, Wog, Xu, Xu, Xu, Xu, Qxu, Qxu, Qxu, Uu^Vu, Uu, 5 Kud, Qxu, Uu, Qxu, Qxu, Xu, Xu, Xu, Xu, Xu, Qxu, Qxu, Qxu, Xu, Xu, Xu, Xu
Xu, Xu, Xu, Xu, Xu, Xu, Xu, Xu, Xu, Xu, Xu, Uh, Rb, Rb, Xu, Xu, Xu, Wwg, Wog, Xu, Xu, Xu, Xu, Xu, Xu, Xu, Qxu, Qxu, Qxu, Qxu, Qxu^Bs/, Uu, Xu, Xu, Xu, Xu, Xu, Xu, Qxu, Qxu, Xu, Xu, Xu, Xu, Xu, Xu
