border_size=1
usage=map

Gs^Fds, Gg, Gs^Fds, Gs^Fds, Gs^Fds, Gg, Gg, Ww, Wwf, Gg, Gs^Fds, Gg, Gs^Fds, Gg, Gg, Gg, Gg, Gs^Fds, Gs^Fds, Gs^Fds, Gg, Gg
Gg, Gs^Fds, Gg, Gg, Gg, Gg, Gs^Fds, Gg, Ww^Ewf, Gg, Gg, Gs^Fds, Gs^Fds, Gg^Ve, Gs^Fds, Gg, Gg, Gs^Fds, Gg, Gg, Gg, Gg
Gg, Gg, Gs^Fds, Gg^Efm, Gg, Gs^Fds, Gs^Fds, Gs^Fds, Ww, Gs^Fds, Gs^Fds, Gs^Fds, Gs^Fds, Gs^Fds, Gg, Gg, Gg, Gg, Gg, Gg^Efm, Gg, Gg
Gg, Gs^Fds, Gs^Fds, Gs^Fms, Gs^Fds, Gg^Fet, Gs^Fds, Gs^Fms, Wwf, Ww^Ewl, Wwf, Wwf, Gs^Fds, Gg^Fet, Gg, 3 Gg^Efm, Gg, Gg, Gs^Fds, Gg, Gs^Fds, Gg
Gg, Gg, Gg, Gs^Fds, Gg, Gs^Fds, Gs^Fds, Gs^Fds, Gg, Gg, Gg, Wwr, Ww, Gg, Gg, Gg, Wwf, Gs^Fds, Ww^Ewf, Gs^Fds, Gs^Fds, Gs^Fds
Gs^Fds, Gs^Fds, Gg, Gg, Gs^Fds, Gg, Gg^Efm, Gg, Gg, Gs^Fds, Gs^Fds, Gg, Gg, 2 Ww^Bsb/, Ww, Wwf, Gs^Fds, Ww, Wwf, Gs^Fds, Wwf, Gs^Fds
Gs^Fds, Gg, Gg, Gs^Fds, Gs^Fds, Gg, Gg, Gg, Gg, Gs^Fds, Gg, Gg, Gs^Fds, Gg, Ww^Ewf, Wwf, Gs^Fds, Gs^Fds, Gg, Wwr, Gs^Fms, Ww^Ewl
Gg, Gg, Gg, Gs^Fms, Gs^Fds, Gg, Gs^Fds, Gs^Fms, Gs^Fds, Gg, Gg, Gs^Fds, Gs^Fms, Gg, Gs^Fds, Gs^Fds, Gg, Gg, Gg, Gs^Fds, Gs^Fds, Gs^Fds
Gg, Gg, Gg, Gg, Gll, Gg, Gs^Fds, Gs^Fds, Gg, Gg, Gg, Gs^Fds, Gs^Fds, Gg, Gg, Gg, Gs^Fds, Gg, Gg^Efm, Gg, Gg, Gg
Gd, Gll, Gd, Gg, Gll, Gg, Gg, Gg, Gg, Gg, Gs^Fds, Gs^Fds, Gg, Gg, Gs^Fds, Gs^Fds, Gs^Fms, Gg, Gg, Gg, Gg^Fet, Gg
Gll, Gd, Gd, Gll, Gll, Gll, Gd, Gd, Gll, Gg, Gll, Gg, Gg, Gg, Gg, Gs^Fds, Gs^Fds, Gg, Gg, Gs^Fds, Gs^Fds, Gs^Fds
Gll, Gll, Gll, Gll, Gll, Gd, Gll, Gd, Gll, Gll, Gll, Gd, Gd, Gg, Gll, Gg, Gg, Gs^Fds, Gg, Gg, Gs^Fds, Gs^Fds
Gll, Gll, Gll, Gll, Gll, Gll, Gll, Gll, Gll^Fdf, Gll, Gll, Gd, Gd, Gd, Gll, Gll, Gll, Gg, Gll, Gg, Gg, Gs^Fms
Gll, Gll, Gd^Es, Gd, Gd, Gll, Gll^Fmf, Gll^Fdf, Gll^Em, Gll^Fdw, Gll, Gll, Gll, Gll, Gll^Fmf, Gll, Gd, Gll, Gd, Gll, Gg, Gg
Gd, Gd, Gd, Gd, Gll, Gll^Fdw, Gd^Es, Gll^Fdf, Gd, Gll, Gll^Fdw, Gd, Gll^Fdw, Gll^Fdf, Gll^Fdf, Gll, Gll, Gll^Fmf, Gll^Fmf, Gd, Gll, Gg
Gd, Gd, Gll, Gd, Gd, Gd, Gd, Gd, Gll^Fdf, Gll^Fdf, Gll^Fmf, Gd, Gll, Gll^Em, Gll, Gll, Gll^Fdf, Hhd^Fmf, Hhd^Fmf, Gd, Gll^Fdf, Gll
Gd, Gs^Es, Gs, Gll^Fmf, Gll^Fdf, Gd, Gll^Fdf, Gd, Gll^Fdw, Hhd^Fdf, Gll^Fdf, Hhd^Fdw, Gll^Fdf, Gll, Gd, Gll, Gll^Fmf, Hhd^Fdw, Gll^Fmf, Hhd^Fdf, Gll^Fdf, Gll^Fmf
Gd, Gd, Gs, Gll^Fdf, Gll^Em, Gll^Fdf, Gll^Fmf, Gd, Gd, Gd, 1 Gd, Gll^Fdw, Gd, Gd, Gd, Gll, Gll, Gd, Gll^Fdf, Gll^Em, Gd, Gd
Gd, Gd, Gd^Em, Gll, Gll, Gll^Fdf, Gll, Gd, Gll^Fdf, Gd, Gd, Gll, Gll^Fdf, Gd^Es, Gll^Fmf, Gll^Fdf, Gll^Fmf, Gd, Gd^Es, Gll^Fdf, Hhd^Fmw, Gd
Gll, Gll^Fdf, Gll^Fmf, Gd, Gll^Fdf, Gll, Gll^Es, Gll^Fdw, Gll^Fdf, Gll, Gd^Fetd, Gll, Rp, Gll^Fdf, Gs^Vc, Gll^Fdf, Gd, Gd, Gd^Em, Gll^Fmf, Gll^Fdf, Gll^Fdf
Gll^Fdf, Hhd^Fdw, Hhd^Fdf, Gll^Fdf, Hhd^Fdw, Gll^Fmf, Gll^Fdf, Gll^Fdf, Gll^Es, Gll, Rp, Rp, Gll^Fdf, Rp, Rp, Rp, Rp, Gll, Gll, Gll^Fdf, Gll, Gll
Gll, Gll^Fdf, Hhd^Fdf, Hhd^Fmw, Gll^Fdf, Gll^Fdf, Gll, Gll, Rp, Rp, Gll, Gll^Fdf, Gll^Fdf, Gll^Fmf, Gll^Fdf, Gll^Fdf, Gll^Es, Rp, Rp, Gll, Gll, Gll^Fdf
